NO ./texture/north_air.xpm
SO ./texture/south_fire.xpm
WE ./texture/west_water.xpm
EA ./texture/east_earth.xpm

C 150,255,255
F 102,153,153

111     11111  111111111111111111
        1000111100110000111100001
        10110000011100001  100001
        100110000000000011 100001
111111111011000001110000011100001
100000000011000001110111111111111
11110111111111010000000010001
1111D111111111011101010010001
11000000110101011100000010001
11100000000000000000000010001
10D00000E00000001101010010001
111000011111011111110111100111
11110111  10001 101111010001
11111111  11111 111111111111