NO ./texture/north_air.xpm
SO ./texture/south_fire.xpm
WE ./texture/west_water.xpm
EA ./texture/east_earth.xpm

C 150,255,255
F 102,153,153

1111111111
1001010001
1000000001
1001010001
1000N00001
1111111111